{
	"author": "John Jelatis",
	"name": "Demo World",
	"difficulty": 0,
	"level": [
		[2,2,2,2,2,2,2,2,2,2,2,2,2,2,2,2,2,5,5,2,2,2,2,2,2,2,2,2,2,2,2,2,2,2,2,2],
		[2,2,2,2,0,0,0,2,2,2,2,2,2,2,2,2,2,5,5,2,2,2,2,2,2,2,2,2,2,2,2,2,2,2,2,2],
		[2,2,2,0,0,0,0,2,2,2,2,2,2,2,2,2,5,5,2,2,2,2,2,2,2,2,2,2,2,2,2,2,2,2,2,2],
		[2,2,0,0,0,0,0,2,2,2,2,1,1,1,2,2,5,5,2,2,2,2,2,2,2,2,2,2,2,2,2,2,2,2,2,2],
		[2,2,2,2,0,0,4,4,4,2,1,1,3,1,1,2,5,5,2,2,2,2,2,2,2,2,2,2,2,2,2,2,2,2,2,2],
		[2,2,2,2,2,2,4,4,4,2,2,2,4,2,2,5,5,5,2,2,2,2,2,2,2,2,2,2,2,2,2,2,2,2,2,2],
		[2,2,2,2,2,2,4,4,4,4,4,4,4,2,5,5,5,2,2,2,2,2,2,2,2,2,2,2,2,2,2,2,2,2,2,2],
		[2,2,2,2,2,2,2,2,2,2,2,2,2,2,5,5,2,2,2,2,2,2,2,2,2,2,2,2,2,2,1,1,1,2,2,2],
		[2,2,2,2,2,2,2,2,2,2,2,2,2,2,5,5,2,2,2,2,2,2,2,2,2,2,2,2,2,1,1,3,1,1,2,2],
		[2,2,2,2,2,2,2,2,2,2,2,2,2,2,5,5,2,2,2,2,2,2,2,2,2,2,2,2,2,2,2,4,2,2,2,2],
		[2,2,2,2,2,2,2,2,2,2,2,2,2,2,5,5,2,2,2,2,2,2,2,2,2,2,2,2,2,2,2,4,2,2,2,2],
		[2,2,2,2,2,2,2,2,2,2,2,2,2,5,5,2,2,2,2,2,2,2,2,2,2,2,2,2,2,2,4,4,2,2,2,2],
		[2,2,2,2,2,2,2,2,2,2,2,2,2,5,5,2,2,2,2,2,2,2,2,2,2,2,2,2,2,4,4,2,2,2,2,2],
		[2,2,2,2,2,2,2,2,2,2,2,2,2,5,5,2,2,2,2,2,2,2,2,2,2,2,2,2,2,4,2,2,2,2,2,2],
		[2,2,2,2,2,2,2,2,2,2,2,2,2,2,5,5,2,2,2,2,2,2,2,1,1,1,2,2,2,4,2,2,2,2,2,2],
		[2,2,2,2,2,2,2,2,2,2,2,2,2,2,5,5,5,2,2,2,2,2,1,1,3,1,1,2,2,4,2,2,2,2,2,2],
		[2,2,2,2,2,2,2,2,2,2,2,2,2,2,2,5,5,5,2,2,2,2,2,2,4,2,2,2,4,4,2,2,2,2,2,2],
		[2,2,2,2,2,2,2,2,2,2,2,2,2,2,2,2,5,5,2,2,2,2,2,2,4,4,2,4,4,2,2,2,2,2,2,2],
		[2,2,2,2,2,2,2,2,2,2,2,2,2,2,2,2,5,5,2,2,2,2,2,2,2,4,4,4,2,2,2,2,2,2,2,2],
		[2,2,2,2,2,2,2,2,2,2,2,2,2,2,2,2,5,5,2,2,2,2,2,2,2,2,2,2,2,2,2,2,2,2,2,2],
		[2,2,2,2,2,2,2,2,2,2,2,2,2,2,2,5,5,5,5,2,2,2,2,2,2,2,2,2,2,2,2,2,2,2,2,2],
		[2,2,2,2,2,2,2,2,2,2,2,2,2,2,5,5,1,1,5,5,2,2,2,2,2,2,2,2,2,2,2,2,2,2,2,2],
		[2,2,2,2,2,2,2,2,2,2,2,2,2,5,5,1,1,1,1,5,5,2,5,5,5,5,5,5,5,5,5,5,5,5,5,5],
		[5,5,5,5,5,5,5,5,5,5,5,5,5,5,1,1,1,1,1,1,5,5,5,2,2,2,2,2,2,2,2,2,2,2,2,2],
		[2,2,2,2,2,2,2,2,2,2,2,2,2,2,2,6,6,6,6,2,2,2,2,2,2,2,2,2,2,2,2,2,2,2,2,2],
		[2,2,2,2,2,2,2,2,2,2,2,2,2,2,2,6,3,6,6,2,2,2,2,2,2,2,2,2,2,2,2,2,2,2,2,2],
		[2,2,2,2,2,2,2,2,2,2,2,2,2,2,2,6,3,6,6,2,2,2,2,2,2,2,2,2,2,2,2,2,2,2,2,2],
		[2,2,2,2,2,2,2,2,2,2,2,2,2,2,2,2,4,2,2,2,2,2,2,2,2,2,2,2,2,2,2,2,2,2,2,2],
		[2,2,2,2,2,2,2,2,2,2,2,2,2,2,2,2,4,2,2,2,2,2,2,2,2,2,2,2,2,2,2,2,2,2,2,2],
		[2,2,2,2,2,2,2,2,2,2,2,2,2,2,2,2,4,4,2,2,2,2,2,2,2,2,2,2,2,2,2,2,2,2,2,2],
		[2,2,2,2,2,2,2,2,2,2,2,2,2,2,2,2,2,4,4,4,2,2,2,2,4,4,4,2,2,2,2,2,2,2,2,2],
		[2,2,2,2,2,2,2,2,2,2,2,2,2,2,2,2,2,2,4,4,4,4,4,4,4,4,4,2,2,2,2,2,2,2,2,2],
		[2,2,2,2,2,2,2,2,2,2,2,2,2,2,2,2,2,2,2,2,2,2,2,2,4,4,4,2,2,2,2,2,2,2,2,2],
		[2,2,2,2,2,2,2,2,2,2,2,2,2,2,2,2,2,2,2,2,2,2,2,2,2,2,2,2,2,2,2,2,2,2,2,2],
		[2,2,2,2,2,2,2,2,2,2,2,2,2,2,2,2,2,2,2,2,2,2,2,2,2,2,2,2,2,2,2,2,2,2,2,2],
		[2,2,2,2,2,2,2,2,2,2,2,2,2,2,2,2,2,2,2,2,2,2,2,2,2,2,2,2,2,2,2,2,2,2,2,2]
	],
	"warps": {
		"warps": [[13, 4, 32, 10],
					[32, 8, 13, 6],
					[25, 16, 17, 28],
					[17, 26, 25, 17]]
	}
}